10 10
1 1
7 10
5 1 3 5 2 4 8 1 X X
X 5 3 3 X 4 2 4 3 3
X 2 X 4 1 2 3 1 X 1
1 7 X 1 3 4 2 2 5 7
3 3 2 3 X 3 X 1 2 4
3 3 3 1 2 6 5 1 7 5
X 2 1 4 2 3 1 4 2 2
1 10 2 X 1 1 8 1 4 4
X 4 7 5 2 1 2 X 5 1
3 3 2 5 7 X 1 2 4 X