10 10
9 1
1 8
2 2 1 2 3 2 1 6 1 3
X X 7 1 3 3 1 8 3 2
1 2 4 3 X 1 3 2 1 6
2 8 4 X 4 1 6 2 3 1
5 6 3 1 3 4 2 4 2 3
X 4 1 X 2 1 3 2 1 2
3 1 1 3 X 2 4 6 X 3
X 1 3 2 4 2 1 2 1 3
2 4 X 2 1 1 3 9 7 X
5 X 8 4 9 3 2 X 2 8
